BBBBBBBB
B    R B
B   GX B
BR  X  B
B      B
BBBBBBBB