BBBBBBBB
B  B   B
B XRRX B
BGXRE BB
B XRRX B
B  B   B
BBBBBBBB