  BBBB   
BBB  BBBB
B     X B
B B  BX B
B R RBG B
BBBBBBBBB