BBBBBBBBBBBBBBBBBBBBBBBBBBBBBBBBBBBBBBBBBBBBBBBBBBBBBBBBBBBBBBBBBBBBBBBBBBBBBBBBBBBBBBBBBBBBBBBBBBBBBBBBB
B                                                                                                       B
B                                                          X                                            B
B                                                                                                       B
B                                                                                                       B
B                                                                                                       B
B                                                                                                       B
B                                                                                                       B
B                       G                                                                               B
B                                                                               R                       B
B                                                                                                       B
B                                                                                                       B
BBBBBBBBBBBBBBBBBBBBBBBBBBBBBBBBBBBBBBBBBBBBBBBBBBBBBBBBBBBBBBBBBBBBBBBBBBBBBBBBBBBBBBBBBBBBBBBBBBBBBBBBB